Abra -> Lamantine
Saquedeneu -> Parécool
Cacnea -> Galegon
Salamèche -> Roucarnage
Monaflèmit -> Taupiqueur
Stari -> Sulfura
Deoxys -> Tentacool
Granbull -> Lainergie
Rémoraid -> Grotadmorv
Colossinge -> Migalos
Lombre -> Excelangue
Tengalice -> Métalosse
Ramoloss -> Balignon
Amonistar -> Nidorina
Ymphect -> Malosse
Krabby -> Scorplane
Chamallot -> Monaflèmit
Grainipiot -> Tengalice
Roucoups -> Relicanth
Goupix -> Kaimorse
Sharpedo -> Maskadra
Bekipan -> Zigzaton
Granivol -> Persian
Mysdibule -> Barbicha
Ptéra -> Mewtwo
Héricendre -> Phanpy
Avaltout -> Flagadoss
Bekipan -> Embrylex
Mysdibule -> Rhinoféros
Héliatronc -> Nostenfer
Hypocéan -> Terhal
Stalgamin -> Marill
Otaria -> Sabelette
Persian -> Noadkoko
Stalgamin -> Lippoutou
Phanpy -> Chrysacier
Suicune -> Sharpedo
Ninjask -> Crustabri
Debugant -> Galegon
Carapuce -> Colossinge
Muciole -> Raichu
Sabelette -> Tylton
Ursaring -> Loupio
Coquiperl -> Doduo
Téraclope -> Rattatac
Corayon -> Charmillon
Paras -> Sablaireau
Ymphect -> Barbicha
Négapi -> Otaria
Arakdo -> Coxy
